# Level Zero Extraction
# Default Hotkeys for Humans (for use with VoiceAttack)
Move Forward: W 
Move Backward: S
Move Left: A
Move Right: D
Lean Left: Q 
Lean Right: E
Jump: Space Bar
Crouch: Left Ctrl
Sprint: Left Shift
Radial Menu: C
Inventory: Tab
Map: M
Interact: F
Aim / Throw: Right Mouse Button
Shoot / Use Item / Punch: Left Mouse Button
Reload (Hold – Reload Radial Menu): R
Stock Strike: Z
Weapon Laser: K
Weapon Flashlight: L
Helmet Light (Double Press – Flash): T
Give Up: H
Hide Item: X
Drop Item: G
Ping: Middle Mouse Button
Quick Slot 1: 1
Quick Slot 2: 2
Quick Slot 3: 3
Quick Slot 4: 4
Quick Slot 5: 5
Voice Chat: V
